5 5
2 5 1 3 1
5 4 2 5 2
3 4 4 3 3
1 5 3 4 1
3 5 5 3 3
3 4 0
0 2 0