7 7
1 3 5 4 5 5 5
3 2 4 2 4 3 2
2 5 1 1 3 1 5
3 3 2 2 1 5 1
3 2 2 1 2 5 3
5 4 5 1 5 5 3
2 5 1 3 1 1 2
5 6 0
4 2 0