9 9
1 1 1 4 1 2 5 3 4
3 2 3 4 4 4 3 4 5
4 5 5 5 2 1 4 2 1
3 4 5 5 4 3 2 1 3
5 1 1 3 1 3 2 5 5
2 3 5 3 3 1 4 2 1
2 3 3 3 5 3 5 4 4
1 2 4 4 3 4 4 4 3
3 4 2 2 1 2 2 1 5
3 3 0
3 0 0